XXXXXXXX
X X X  X
X      X
X      X
XXXXXXXX